11111111111111111111
10010110111100111001
10110100010000110011
10101111111111100111
10010000000000000101
10100000000000001001
11011100000000101001
10001000011110001001
10100000010000111001
10001000000110111111
11101000010110000001
11011001110111001111
11110000010111000001
10000111100111100001
10100001100111111111
10000000000000000001
10101000011100000001
10101100111110000101
10000000000000000001
11111111111111111111