11111111111111111111
10001001000011000001
10101011101111001101
10111000000000011001
10011111111111110011
10100000000000010101
11011111111111010101
10000011100001110101
10111111101111000001
10000000001001000001
11110111101001111001
11100110001000100001
11001111111001111101
10011000011000000001
10111110011001111111
10000000000000000001
10110111100011111111
10110011000001111001
10000000000000000001
11111111111111111111